                                                                 *  *                                                *    *
                                                                 *  *                                                *    *
                                                                 *  *                                                *    *
                                                                 *  *                                                *    *
                                                                 *  *                                                *    *
                                                                 *  *                                                *    *
                                                                 *  *                                                *    *
                                                                 *  *                                                *    *
                                                                 *  *                                                *    *
                                                                 *  *                                                *    *
                                                                 *  *                                                ******   
                                                                 *  *                                                   g
                                                                 *  *                                                
                                                                 *  *                                                 
                                                                 *  *                                                ******
                                                                 *  *                          b                     ******                                            b
                                                                 ****                        
                                                         b               ***************************   **************************************************************************************
                  ***********                               **************                         *   *
*******************         *    ***********            *****                                      *   *
                            *    *         **************                                          *   *
                            *    *                                                                 *   *
                            *    *                                                                 *   *
                            *    *                                                                 *   *
                            *    *                                                                 *   *
                            *    *                                                                 *   *
                            *    *                                                                 *   *
                            *    *                                                                 *   *
                            *    *                                                                 *   *
                            *    *                                                                 *   *