                                                                 *  *                                                *    *
                                                                 *  *                                                *    *
                                                                 *  *                                                *    *
                                                                 *  *                                                *    *
                                                                 *  *                                                *    *
                                                                 *  *                                                *    *
                                                                 *  *                                                *    *
                                                                 *  *                                                *    *
                                                                 *  *                                                *    *
                                                                 *  *                                                *    *
                                                                 *  *                                                ******   
                                                                 *  *                                                hhhhhh   
                                                                 *  *                                                hhhhhh
                                                                 *  *                                                hhhhhh 
                                                                 *  *                                                ******
                                                                 *  *                                                ******
                                                                 ****                                                                                                                    c
                                                                         ***************************   **************************************************************************************
                  ***********                               **************                         *   *
*******************         *    ***********            *****                                      *   *
                            *    *         **************                                          *   *
                            *    *                                                                 *   *
                            *    *                                                                 *   *
                            *    *                                                                 *   *
                            *    *                                                                 *   *
                            *    *                                                                 *   *
                            *    *                                                                 *   *
                            *    *                                                                 *   *
                            *    *                                                                 *   *
                            *    *                                                                 *   *